"quarter","startday.index","start.date","outside","mensick.week","mendead.week","womensick.week","womendead.week","sick.total.week","dead.total.week","est.pop.1853","normal.incidence","normal.mortality","week.id","quarterID","cum.sick","S","R"
"Christianshavn",0,1853-06-12,0,0,0,0,0,0,0,15836,0,0,0,1,0,15836,0
"Christianshavn",7,1853-06-19,0,1,1,0,0,1,1,15836,0.06,0.06,1,1,1,15835,0
"Christianshavn",14,1853-06-26,0,0,0,4,1,4,1,15836,0.25,0.06,2,1,5,15831,1
"Christianshavn",21,1853-07-03,0,4,3,9,6,13,9,15836,0.82,0.57,3,1,18,15818,5
"Christianshavn",28,1853-07-10,0,45,29,57,48,102,77,15836,6.44,4.86,4,1,120,15716,18
"Christianshavn",35,1853-07-17,0,149,108,158,119,307,227,15836,19.39,14.33,5,1,427,15409,120
"Christianshavn",42,1853-07-24,0,221,151,228,155,449,306,15836,28.35,19.32,6,1,876,14960,427
"Christianshavn",49,1853-07-31,0,120,69,129,71,249,140,15836,15.72,8.84,7,1,1125,14711,876
"Christianshavn",56,1853-08-07,0,43,15,49,20,92,35,15836,5.81,2.21,8,1,1217,14619,1125
"Christianshavn",63,1853-08-14,0,12,6,12,7,24,13,15836,1.52,0.82,9,1,1241,14595,1217
"Christianshavn",70,1853-08-21,0,9,4,8,5,17,9,15836,1.07,0.57,10,1,1258,14578,1241
"Christianshavn",77,1853-08-28,0,7,4,2,2,9,6,15836,0.57,0.38,11,1,1267,14569,1258
"Christianshavn",84,1853-09-04,0,5,3,2,1,7,4,15836,0.44,0.25,12,1,1274,14562,1267
"Christianshavn",91,1853-09-11,0,1,1,0,0,1,1,15836,0.06,0.06,13,1,1275,14561,1274
"Christianshavn",98,1853-09-18,0,2,2,0,0,2,2,15836,0.13,0.13,14,1,1277,14559,1275
"Christianshavn",105,1853-09-25,0,0,0,1,1,1,1,15836,0.06,0.06,15,1,1278,14558,1277
"Fra skibe",0,1853-06-12,0,0,0,0,0,0,0,NA,NA,NA,0,2,0,NA,NA
"Fra skibe",7,1853-06-19,0,5,5,0,0,5,5,NA,NA,NA,1,2,5,NA,NA
"Fra skibe",14,1853-06-26,0,8,4,0,0,8,4,NA,NA,NA,2,2,13,NA,NA
"Fra skibe",21,1853-07-03,0,13,8,0,0,13,8,NA,NA,NA,3,2,26,NA,NA
"Fra skibe",28,1853-07-10,0,20,13,0,0,20,13,NA,NA,NA,4,2,46,NA,NA
"Fra skibe",35,1853-07-17,0,25,15,0,0,25,15,NA,NA,NA,5,2,71,NA,NA
"Fra skibe",42,1853-07-24,0,20,10,0,0,20,10,NA,NA,NA,6,2,91,NA,NA
"Fra skibe",49,1853-07-31,0,10,3,0,0,10,3,NA,NA,NA,7,2,101,NA,NA
"Fra skibe",56,1853-08-07,0,2,1,0,0,2,1,NA,NA,NA,8,2,103,NA,NA
"Fra skibe",63,1853-08-14,0,7,5,1,1,8,6,NA,NA,NA,9,2,111,NA,NA
"Fra skibe",70,1853-08-21,0,2,2,0,0,2,2,NA,NA,NA,10,2,113,NA,NA
"Fra skibe",77,1853-08-28,0,4,1,0,0,4,1,NA,NA,NA,11,2,117,NA,NA
"Fra skibe",84,1853-09-04,0,1,0,0,0,1,0,NA,NA,NA,12,2,118,NA,NA
"Fra skibe",91,1853-09-11,0,4,1,0,0,4,1,NA,NA,NA,13,2,122,NA,NA
"Fra skibe",98,1853-09-18,0,0,0,0,0,0,0,NA,NA,NA,14,2,122,NA,NA
"Fra skibe",105,1853-09-25,0,0,0,0,0,0,0,NA,NA,NA,15,2,122,NA,NA
"Frimands",0,1853-06-12,0,0,0,0,0,0,0,4951,0,0,0,3,0,4951,0
"Frimands",7,1853-06-19,0,0,0,0,0,0,0,4951,0,0,1,3,0,4951,0
"Frimands",14,1853-06-26,0,0,0,0,0,0,0,4951,0,0,2,3,0,4951,0
"Frimands",21,1853-07-03,0,2,1,0,0,2,1,4951,0.4,0.2,3,3,2,4949,0
"Frimands",28,1853-07-10,0,1,1,1,0,2,1,4951,0.4,0.2,4,3,4,4947,2
"Frimands",35,1853-07-17,0,7,5,6,3,13,8,4951,2.63,1.62,5,3,17,4934,4
"Frimands",42,1853-07-24,0,5,4,6,5,11,9,4951,2.22,1.82,6,3,28,4923,17
"Frimands",49,1853-07-31,0,6,4,8,4,14,8,4951,2.83,1.62,7,3,42,4909,28
"Frimands",56,1853-08-07,0,3,3,2,1,5,4,4951,1.01,0.81,8,3,47,4904,42
"Frimands",63,1853-08-14,0,1,1,1,1,2,2,4951,0.4,0.4,9,3,49,4902,47
"Frimands",70,1853-08-21,0,3,2,1,0,4,2,4951,0.81,0.4,10,3,53,4898,49
"Frimands",77,1853-08-28,0,0,0,0,0,0,0,4951,0,0,11,3,53,4898,53
"Frimands",84,1853-09-04,0,0,0,0,0,0,0,4951,0,0,12,3,53,4898,53
"Frimands",91,1853-09-11,0,0,0,0,0,0,0,4951,0,0,13,3,53,4898,53
"Frimands",98,1853-09-18,0,0,0,0,0,0,0,4951,0,0,14,3,53,4898,53
"Frimands",105,1853-09-25,0,0,0,0,0,0,0,4951,0,0,15,3,53,4898,53
"Kjoebmager",0,1853-06-12,0,0,0,0,0,0,0,11544,0,0,0,4,0,11544,0
"Kjoebmager",7,1853-06-19,0,0,0,1,1,1,1,11544,0.09,0.09,1,4,1,11543,0
"Kjoebmager",14,1853-06-26,0,1,1,1,0,2,1,11544,0.17,0.09,2,4,3,11541,1
"Kjoebmager",21,1853-07-03,0,0,0,4,3,4,3,11544,0.35,0.26,3,4,7,11537,3
"Kjoebmager",28,1853-07-10,0,17,11,8,4,25,15,11544,2.17,1.3,4,4,32,11512,7
"Kjoebmager",35,1853-07-17,0,21,12,27,11,48,23,11544,4.16,1.99,5,4,80,11464,32
"Kjoebmager",42,1853-07-24,0,47,30,38,25,85,55,11544,7.36,4.76,6,4,165,11379,80
"Kjoebmager",49,1853-07-31,0,42,22,48,24,90,46,11544,7.8,3.98,7,4,255,11289,165
"Kjoebmager",56,1853-08-07,0,17,12,21,13,38,25,11544,3.29,2.17,8,4,293,11251,255
"Kjoebmager",63,1853-08-14,0,6,2,12,5,18,7,11544,1.56,0.61,9,4,311,11233,293
"Kjoebmager",70,1853-08-21,0,4,1,9,5,13,6,11544,1.13,0.52,10,4,324,11220,311
"Kjoebmager",77,1853-08-28,0,6,0,5,2,11,2,11544,0.95,0.17,11,4,335,11209,324
"Kjoebmager",84,1853-09-04,0,2,0,1,0,3,0,11544,0.26,0,12,4,338,11206,335
"Kjoebmager",91,1853-09-11,0,1,0,0,0,1,0,11544,0.09,0,13,4,339,11205,338
"Kjoebmager",98,1853-09-18,0,0,0,1,1,1,1,11544,0.09,0.09,14,4,340,11204,339
"Kjoebmager",105,1853-09-25,0,0,0,0,0,0,0,11544,0,0,15,4,340,11204,340
"Klaedebo",0,1853-06-12,0,0,0,0,0,0,0,6887,0,0,0,5,0,6887,0
"Klaedebo",7,1853-06-19,0,0,0,0,0,0,0,6887,0,0,1,5,0,6887,0
"Klaedebo",14,1853-06-26,0,0,0,0,0,0,0,6887,0,0,2,5,0,6887,0
"Klaedebo",21,1853-07-03,0,0,0,1,0,1,0,6887,0.15,0,3,5,1,6886,0
"Klaedebo",28,1853-07-10,0,5,5,2,1,7,6,6887,1.02,0.87,4,5,8,6879,1
"Klaedebo",35,1853-07-17,0,9,4,18,16,27,20,6887,3.92,2.9,5,5,35,6852,8
"Klaedebo",42,1853-07-24,0,17,8,17,12,34,20,6887,4.94,2.9,6,5,69,6818,35
"Klaedebo",49,1853-07-31,0,6,6,6,4,12,10,6887,1.74,1.45,7,5,81,6806,69
"Klaedebo",56,1853-08-07,0,2,2,4,4,6,6,6887,0.87,0.87,8,5,87,6800,81
"Klaedebo",63,1853-08-14,0,3,0,1,1,4,1,6887,0.58,0.15,9,5,91,6796,87
"Klaedebo",70,1853-08-21,0,2,0,2,1,4,1,6887,0.58,0.15,10,5,95,6792,91
"Klaedebo",77,1853-08-28,0,0,0,2,1,2,1,6887,0.29,0.15,11,5,97,6790,95
"Klaedebo",84,1853-09-04,0,1,1,1,1,2,2,6887,0.29,0.29,12,5,99,6788,97
"Klaedebo",91,1853-09-11,0,0,0,2,2,2,2,6887,0.29,0.29,13,5,101,6786,99
"Klaedebo",98,1853-09-18,0,0,0,0,0,0,0,6887,0,0,14,5,101,6786,101
"Klaedebo",105,1853-09-25,0,0,0,0,0,0,0,6887,0,0,15,5,101,6786,101
"Ladegaarden",0,1853-06-12,1,0,0,0,0,0,0,NA,NA,NA,0,6,0,NA,NA
"Ladegaarden",7,1853-06-19,1,0,0,0,0,0,0,NA,NA,NA,1,6,0,NA,NA
"Ladegaarden",14,1853-06-26,1,0,0,0,0,0,0,NA,NA,NA,2,6,0,NA,NA
"Ladegaarden",21,1853-07-03,1,3,2,12,9,15,11,NA,NA,NA,3,6,15,NA,NA
"Ladegaarden",28,1853-07-10,1,6,6,7,6,13,12,NA,NA,NA,4,6,28,NA,NA
"Ladegaarden",35,1853-07-17,1,14,11,7,4,21,15,NA,NA,NA,5,6,49,NA,NA
"Ladegaarden",42,1853-07-24,1,8,7,5,4,13,11,NA,NA,NA,6,6,62,NA,NA
"Ladegaarden",49,1853-07-31,1,5,2,2,1,7,3,NA,NA,NA,7,6,69,NA,NA
"Ladegaarden",56,1853-08-07,1,3,2,1,0,4,2,NA,NA,NA,8,6,73,NA,NA
"Ladegaarden",63,1853-08-14,1,1,0,0,0,1,0,NA,NA,NA,9,6,74,NA,NA
"Ladegaarden",70,1853-08-21,1,5,3,0,0,5,3,NA,NA,NA,10,6,79,NA,NA
"Ladegaarden",77,1853-08-28,1,1,0,0,0,1,0,NA,NA,NA,11,6,80,NA,NA
"Ladegaarden",84,1853-09-04,1,0,0,0,0,0,0,NA,NA,NA,12,6,80,NA,NA
"Ladegaarden",91,1853-09-11,1,0,0,0,0,0,0,NA,NA,NA,13,6,80,NA,NA
"Ladegaarden",98,1853-09-18,1,0,0,0,0,0,0,NA,NA,NA,14,6,80,NA,NA
"Ladegaarden",105,1853-09-25,1,0,0,0,0,0,0,NA,NA,NA,15,6,80,NA,NA
"Noerre",0,1853-06-12,0,0,0,0,0,0,0,9104,0,0,0,7,0,9104,0
"Noerre",7,1853-06-19,0,1,1,0,0,1,1,9104,0.11,0.11,1,7,1,9103,0
"Noerre",14,1853-06-26,0,0,0,0,0,0,0,9104,0,0,2,7,1,9103,1
"Noerre",21,1853-07-03,0,2,1,5,3,7,4,9104,0.77,0.44,3,7,8,9096,1
"Noerre",28,1853-07-10,0,11,9,9,6,20,15,9104,2.2,1.65,4,7,28,9076,8
"Noerre",35,1853-07-17,0,18,12,18,9,36,21,9104,3.95,2.31,5,7,64,9040,28
"Noerre",42,1853-07-24,0,19,15,28,18,47,33,9104,5.16,3.62,6,7,111,8993,64
"Noerre",49,1853-07-31,0,22,14,29,18,51,32,9104,5.6,3.51,7,7,162,8942,111
"Noerre",56,1853-08-07,0,14,6,17,11,31,17,9104,3.41,1.87,8,7,193,8911,162
"Noerre",63,1853-08-14,0,15,10,15,10,30,20,9104,3.3,2.2,9,7,223,8881,193
"Noerre",70,1853-08-21,0,12,8,8,2,20,10,9104,2.2,1.1,10,7,243,8861,223
"Noerre",77,1853-08-28,0,3,2,2,2,5,4,9104,0.55,0.44,11,7,248,8856,243
"Noerre",84,1853-09-04,0,0,0,2,2,2,2,9104,0.22,0.22,12,7,250,8854,248
"Noerre",91,1853-09-11,0,2,0,0,0,2,0,9104,0.22,0,13,7,252,8852,250
"Noerre",98,1853-09-18,0,0,0,0,0,0,0,9104,0,0,14,7,252,8852,252
"Noerre",105,1853-09-25,0,0,0,1,1,1,1,9104,0.11,0.11,15,7,253,8851,252
"Noerrebro",0,1853-06-12,1,0,0,0,0,0,0,NA,NA,NA,0,8,0,NA,NA
"Noerrebro",7,1853-06-19,1,0,0,0,0,0,0,NA,NA,NA,1,8,0,NA,NA
"Noerrebro",14,1853-06-26,1,1,1,0,0,1,1,NA,NA,NA,2,8,1,NA,NA
"Noerrebro",21,1853-07-03,1,1,1,1,0,2,1,NA,NA,NA,3,8,3,NA,NA
"Noerrebro",28,1853-07-10,1,8,7,6,4,14,11,NA,NA,NA,4,8,17,NA,NA
"Noerrebro",35,1853-07-17,1,21,15,37,24,58,39,NA,NA,NA,5,8,75,NA,NA
"Noerrebro",42,1853-07-24,1,49,34,54,34,103,68,NA,NA,NA,6,8,178,NA,NA
"Noerrebro",49,1853-07-31,1,26,21,26,17,52,38,NA,NA,NA,7,8,230,NA,NA
"Noerrebro",56,1853-08-07,1,30,19,32,20,62,39,NA,NA,NA,8,8,292,NA,NA
"Noerrebro",63,1853-08-14,1,0,15,18,9,18,24,NA,NA,NA,9,8,310,NA,NA
"Noerrebro",70,1853-08-21,1,10,6,11,8,21,14,NA,NA,NA,10,8,331,NA,NA
"Noerrebro",77,1853-08-28,1,2,1,2,1,4,2,NA,NA,NA,11,8,335,NA,NA
"Noerrebro",84,1853-09-04,1,0,0,0,0,0,0,NA,NA,NA,12,8,335,NA,NA
"Noerrebro",91,1853-09-11,1,2,2,0,0,2,2,NA,NA,NA,13,8,337,NA,NA
"Noerrebro",98,1853-09-18,1,0,0,1,1,1,1,NA,NA,NA,14,8,338,NA,NA
"Noerrebro",105,1853-09-25,1,1,0,0,0,1,0,NA,NA,NA,15,8,339,NA,NA
"Nyboder",0,1853-06-12,0,2,1,1,1,3,2,7195,0.42,0.28,0,9,3,7192,0
"Nyboder",7,1853-06-19,0,4,1,7,4,11,5,7195,1.53,0.69,1,9,14,7181,3
"Nyboder",14,1853-06-26,0,3,2,5,4,8,6,7195,1.11,0.83,2,9,22,7173,14
"Nyboder",21,1853-07-03,0,5,5,8,7,13,12,7195,1.81,1.67,3,9,35,7160,22
"Nyboder",28,1853-07-10,0,48,36,63,48,111,84,7195,15.43,11.67,4,9,146,7049,35
"Nyboder",35,1853-07-17,0,67,52,108,79,175,131,7195,24.32,18.21,5,9,321,6874,146
"Nyboder",42,1853-07-24,0,51,37,65,52,116,89,7195,16.12,12.37,6,9,437,6758,321
"Nyboder",49,1853-07-31,0,42,21,49,31,91,52,7195,12.65,7.23,7,9,528,6667,437
"Nyboder",56,1853-08-07,0,14,10,14,7,28,17,7195,3.89,2.36,8,9,556,6639,528
"Nyboder",63,1853-08-14,0,7,2,7,1,14,3,7195,1.95,0.42,9,9,570,6625,556
"Nyboder",70,1853-08-21,0,3,2,5,3,8,5,7195,1.11,0.69,10,9,578,6617,570
"Nyboder",77,1853-08-28,0,2,1,1,1,3,2,7195,0.42,0.28,11,9,581,6614,578
"Nyboder",84,1853-09-04,0,0,0,1,1,1,1,7195,0.14,0.14,12,9,582,6613,581
"Nyboder",91,1853-09-11,0,0,0,1,1,1,1,7195,0.14,0.14,13,9,583,6612,582
"Nyboder",98,1853-09-18,0,0,0,0,0,0,0,7195,0,0,14,9,583,6612,583
"Nyboder",105,1853-09-25,0,0,0,0,0,0,0,7195,0,0,15,9,583,6612,583
"Oester",0,1853-06-12,0,0,0,0,0,0,0,8553,0,0,0,10,0,8553,0
"Oester",7,1853-06-19,0,0,0,0,0,0,0,8553,0,0,1,10,0,8553,0
"Oester",14,1853-06-26,0,1,0,2,2,3,2,8553,0.35,0.23,2,10,3,8550,0
"Oester",21,1853-07-03,0,5,2,7,5,12,7,8553,1.4,0.82,3,10,15,8538,3
"Oester",28,1853-07-10,0,12,9,19,11,31,20,8553,3.62,2.34,4,10,46,8507,15
"Oester",35,1853-07-17,0,24,18,61,35,85,53,8553,9.94,6.2,5,10,131,8422,46
"Oester",42,1853-07-24,0,25,13,41,25,66,38,8553,7.72,4.44,6,10,197,8356,131
"Oester",49,1853-07-31,0,6,3,9,6,15,9,8553,1.75,1.05,7,10,212,8341,197
"Oester",56,1853-08-07,0,10,6,16,10,26,16,8553,3.04,1.87,8,10,238,8315,212
"Oester",63,1853-08-14,0,7,5,4,2,11,7,8553,1.29,0.82,9,10,249,8304,238
"Oester",70,1853-08-21,0,2,1,7,2,9,3,8553,1.05,0.35,10,10,258,8295,249
"Oester",77,1853-08-28,0,4,2,2,2,6,4,8553,0.7,0.47,11,10,264,8289,258
"Oester",84,1853-09-04,0,0,0,2,1,2,1,8553,0.23,0.12,12,10,266,8287,264
"Oester",91,1853-09-11,0,0,0,1,0,1,0,8553,0.12,0,13,10,267,8286,266
"Oester",98,1853-09-18,0,0,0,0,0,0,0,8553,0,0,14,10,267,8286,267
"Oester",105,1853-09-25,0,0,0,1,0,1,0,8553,0.12,0,15,10,268,8285,267
"Oesterbro",0,1853-06-12,1,0,0,0,0,0,0,NA,NA,NA,0,11,0,NA,NA
"Oesterbro",7,1853-06-19,1,0,0,0,0,0,0,NA,NA,NA,1,11,0,NA,NA
"Oesterbro",14,1853-06-26,1,0,0,0,0,0,0,NA,NA,NA,2,11,0,NA,NA
"Oesterbro",21,1853-07-03,1,1,0,0,0,1,0,NA,NA,NA,3,11,1,NA,NA
"Oesterbro",28,1853-07-10,1,0,0,0,0,0,0,NA,NA,NA,4,11,1,NA,NA
"Oesterbro",35,1853-07-17,1,8,5,7,6,15,11,NA,NA,NA,5,11,16,NA,NA
"Oesterbro",42,1853-07-24,1,7,4,15,10,22,14,NA,NA,NA,6,11,38,NA,NA
"Oesterbro",49,1853-07-31,1,3,2,1,1,4,3,NA,NA,NA,7,11,42,NA,NA
"Oesterbro",56,1853-08-07,1,0,0,0,0,0,0,NA,NA,NA,8,11,42,NA,NA
"Oesterbro",63,1853-08-14,1,1,0,0,0,1,0,NA,NA,NA,9,11,43,NA,NA
"Oesterbro",70,1853-08-21,1,0,0,0,0,0,0,NA,NA,NA,10,11,43,NA,NA
"Oesterbro",77,1853-08-28,1,0,0,0,0,0,0,NA,NA,NA,11,11,43,NA,NA
"Oesterbro",84,1853-09-04,1,0,0,1,0,1,0,NA,NA,NA,12,11,44,NA,NA
"Oesterbro",91,1853-09-11,1,0,0,0,0,0,0,NA,NA,NA,13,11,44,NA,NA
"Oesterbro",98,1853-09-18,1,0,0,0,0,0,0,NA,NA,NA,14,11,44,NA,NA
"Oesterbro",105,1853-09-25,1,0,0,0,0,0,0,NA,NA,NA,15,11,44,NA,NA
"Rosenborg",0,1853-06-12,0,0,0,0,0,0,0,10214,0,0,0,12,0,10214,0
"Rosenborg",7,1853-06-19,0,0,0,3,1,3,1,10214,0.29,0.1,1,12,3,10211,0
"Rosenborg",14,1853-06-26,0,6,3,12,5,18,8,10214,1.76,0.78,2,12,21,10193,3
"Rosenborg",21,1853-07-03,0,4,3,7,3,11,6,10214,1.08,0.59,3,12,32,10182,21
"Rosenborg",28,1853-07-10,0,25,16,7,5,32,21,10214,3.13,2.06,4,12,64,10150,32
"Rosenborg",35,1853-07-17,0,23,14,30,19,53,33,10214,5.19,3.23,5,12,117,10097,64
"Rosenborg",42,1853-07-24,0,42,23,47,28,89,51,10214,8.71,4.99,6,12,206,10008,117
"Rosenborg",49,1853-07-31,0,31,21,43,29,74,50,10214,7.24,4.9,7,12,280,9934,206
"Rosenborg",56,1853-08-07,0,20,10,20,9,40,19,10214,3.92,1.86,8,12,320,9894,280
"Rosenborg",63,1853-08-14,0,11,2,20,12,31,14,10214,3.04,1.37,9,12,351,9863,320
"Rosenborg",70,1853-08-21,0,11,8,10,10,21,18,10214,2.06,1.76,10,12,372,9842,351
"Rosenborg",77,1853-08-28,0,3,3,2,1,5,4,10214,0.49,0.39,11,12,377,9837,372
"Rosenborg",84,1853-09-04,0,1,1,1,1,2,2,10214,0.2,0.2,12,12,379,9835,377
"Rosenborg",91,1853-09-11,0,2,1,2,1,4,2,10214,0.39,0.2,13,12,383,9831,379
"Rosenborg",98,1853-09-18,0,0,0,0,0,0,0,10214,0,0,14,12,383,9831,383
"Rosenborg",105,1853-09-25,0,0,0,0,0,0,0,10214,0,0,15,12,383,9831,383
"Snarens",0,1853-06-12,0,0,0,0,0,0,0,4674,0,0,0,13,0,4674,0
"Snarens",7,1853-06-19,0,0,0,0,0,0,0,4674,0,0,1,13,0,4674,0
"Snarens",14,1853-06-26,0,3,2,0,0,3,2,4674,0.64,0.43,2,13,3,4671,0
"Snarens",21,1853-07-03,0,0,0,0,0,0,0,4674,0,0,3,13,3,4671,3
"Snarens",28,1853-07-10,0,0,0,1,1,1,1,4674,0.21,0.21,4,13,4,4670,3
"Snarens",35,1853-07-17,0,5,1,10,4,15,5,4674,3.21,1.07,5,13,19,4655,4
"Snarens",42,1853-07-24,0,35,28,25,18,60,46,4674,12.84,9.84,6,13,79,4595,19
"Snarens",49,1853-07-31,0,6,4,9,4,15,8,4674,3.21,1.71,7,13,94,4580,79
"Snarens",56,1853-08-07,0,3,3,7,3,10,6,4674,2.14,1.28,8,13,104,4570,94
"Snarens",63,1853-08-14,0,2,1,3,2,5,3,4674,1.07,0.64,9,13,109,4565,104
"Snarens",70,1853-08-21,0,1,0,2,0,3,0,4674,0.64,0,10,13,112,4562,109
"Snarens",77,1853-08-28,0,3,1,1,0,4,1,4674,0.86,0.21,11,13,116,4558,112
"Snarens",84,1853-09-04,0,0,0,0,0,0,0,4674,0,0,12,13,116,4558,116
"Snarens",91,1853-09-11,0,6,2,3,0,9,2,4674,1.93,0.43,13,13,125,4549,116
"Snarens",98,1853-09-18,0,1,1,1,1,2,2,4674,0.43,0.43,14,13,127,4547,125
"Snarens",105,1853-09-25,0,0,0,0,0,0,0,4674,0,0,15,13,127,4547,127
"St. Annae Oester",0,1853-06-12,0,1,0,0,0,1,0,11917,0.08,0,0,14,1,11916,0
"St. Annae Oester",7,1853-06-19,0,1,1,1,0,2,1,11917,0.17,0.08,1,14,3,11914,1
"St. Annae Oester",14,1853-06-26,0,4,4,2,2,6,6,11917,0.5,0.5,2,14,9,11908,3
"St. Annae Oester",21,1853-07-03,0,35,28,30,26,65,54,11917,5.45,4.53,3,14,74,11843,9
"St. Annae Oester",28,1853-07-10,0,133,102,173,142,306,244,11917,25.68,20.47,4,14,380,11537,74
"St. Annae Oester",35,1853-07-17,0,188,138,316,239,504,377,11917,42.29,31.64,5,14,884,11033,380
"St. Annae Oester",42,1853-07-24,0,59,50,133,101,192,151,11917,16.11,12.67,6,14,1076,10841,884
"St. Annae Oester",49,1853-07-31,0,15,11,22,15,37,26,11917,3.1,2.18,7,14,1113,10804,1076
"St. Annae Oester",56,1853-08-07,0,7,5,10,6,17,11,11917,1.43,0.92,8,14,1130,10787,1113
"St. Annae Oester",63,1853-08-14,0,7,5,9,4,16,9,11917,1.34,0.76,9,14,1146,10771,1130
"St. Annae Oester",70,1853-08-21,0,1,1,1,0,2,1,11917,0.17,0.08,10,14,1148,10769,1146
"St. Annae Oester",77,1853-08-28,0,3,1,0,0,3,1,11917,0.25,0.08,11,14,1151,10766,1148
"St. Annae Oester",84,1853-09-04,0,1,0,0,0,1,0,11917,0.08,0,12,14,1152,10765,1151
"St. Annae Oester",91,1853-09-11,0,0,0,1,0,1,0,11917,0.08,0,13,14,1153,10764,1152
"St. Annae Oester",98,1853-09-18,0,0,0,0,0,0,0,11917,0,0,14,14,1153,10764,1153
"St. Annae Oester",105,1853-09-25,0,1,1,0,0,1,1,11917,0.08,0.08,15,14,1154,10763,1153
"St. Annae Vester",0,1853-06-12,0,0,0,1,1,1,1,24655,0.04,0.04,0,15,1,24654,0
"St. Annae Vester",7,1853-06-19,0,5,5,2,1,7,6,24655,0.28,0.24,1,15,8,24647,1
"St. Annae Vester",14,1853-06-26,0,20,17,20,1,40,18,24655,1.62,0.73,2,15,48,24607,8
"St. Annae Vester",21,1853-07-03,0,76,59,65,47,141,106,24655,5.72,4.3,3,15,189,24466,48
"St. Annae Vester",28,1853-07-10,0,214,151,169,115,383,266,24655,15.53,10.79,4,15,572,24083,189
"St. Annae Vester",35,1853-07-17,0,235,148,257,153,492,301,24655,19.96,12.21,5,15,1064,23591,572
"St. Annae Vester",42,1853-07-24,0,168,96,206,131,374,227,24655,15.17,9.21,6,15,1438,23217,1064
"St. Annae Vester",49,1853-07-31,0,81,45,86,46,167,91,24655,6.77,3.69,7,15,1605,23050,1438
"St. Annae Vester",56,1853-08-07,0,34,21,42,21,76,42,24655,3.08,1.7,8,15,1681,22974,1605
"St. Annae Vester",63,1853-08-14,0,14,8,26,8,40,16,24655,1.62,0.65,9,15,1721,22934,1681
"St. Annae Vester",70,1853-08-21,0,14,7,5,0,19,7,24655,0.77,0.28,10,15,1740,22915,1721
"St. Annae Vester",77,1853-08-28,0,8,5,4,0,12,5,24655,0.49,0.2,11,15,1752,22903,1740
"St. Annae Vester",84,1853-09-04,0,2,0,1,0,3,0,24655,0.12,0,12,15,1755,22900,1752
"St. Annae Vester",91,1853-09-11,0,0,0,2,1,2,1,24655,0.08,0.04,13,15,1757,22898,1755
"St. Annae Vester",98,1853-09-18,0,2,2,2,1,4,3,24655,0.16,0.12,14,15,1761,22894,1757
"St. Annae Vester",105,1853-09-25,0,0,1,0,0,0,1,24655,0,0.04,15,15,1761,22894,1761
"Strand",0,1853-06-12,0,0,0,0,0,0,0,2553,0,0,0,16,0,2553,0
"Strand",7,1853-06-19,0,0,0,0,0,0,0,2553,0,0,1,16,0,2553,0
"Strand",14,1853-06-26,0,0,0,0,0,0,0,2553,0,0,2,16,0,2553,0
"Strand",21,1853-07-03,0,0,0,0,0,0,0,2553,0,0,3,16,0,2553,0
"Strand",28,1853-07-10,0,2,1,1,0,3,1,2553,1.18,0.39,4,16,3,2550,0
"Strand",35,1853-07-17,0,1,0,2,1,3,1,2553,1.18,0.39,5,16,6,2547,3
"Strand",42,1853-07-24,0,4,4,4,1,8,5,2553,3.13,1.96,6,16,14,2539,6
"Strand",49,1853-07-31,0,0,0,2,1,2,1,2553,0.78,0.39,7,16,16,2537,14
"Strand",56,1853-08-07,0,1,0,1,0,2,0,2553,0.78,0,8,16,18,2535,16
"Strand",63,1853-08-14,0,0,0,0,0,0,0,2553,0,0,9,16,18,2535,18
"Strand",70,1853-08-21,0,1,0,1,1,2,1,2553,0.78,0.39,10,16,20,2533,18
"Strand",77,1853-08-28,0,0,0,0,0,0,0,2553,0,0,11,16,20,2533,20
"Strand",84,1853-09-04,0,0,0,0,0,0,0,2553,0,0,12,16,20,2533,20
"Strand",91,1853-09-11,0,0,0,0,0,0,0,2553,0,0,13,16,20,2533,20
"Strand",98,1853-09-18,0,0,0,0,0,0,0,2553,0,0,14,16,20,2533,20
"Strand",105,1853-09-25,0,0,0,0,0,0,0,2553,0,0,15,16,20,2533,20
"Vester",0,1853-06-12,0,0,0,0,0,0,0,8485,0,0,0,17,0,8485,0
"Vester",7,1853-06-19,0,1,1,0,0,1,1,8485,0.12,0.12,1,17,1,8484,0
"Vester",14,1853-06-26,0,0,0,0,0,0,0,8485,0,0,2,17,1,8484,1
"Vester",21,1853-07-03,0,1,1,3,3,4,4,8485,0.47,0.47,3,17,5,8480,1
"Vester",28,1853-07-10,0,3,2,1,0,4,2,8485,0.47,0.24,4,17,9,8476,5
"Vester",35,1853-07-17,0,1,1,6,6,7,7,8485,0.82,0.82,5,17,16,8469,9
"Vester",42,1853-07-24,0,30,19,69,59,99,78,8485,11.67,9.19,6,17,115,8370,16
"Vester",49,1853-07-31,0,14,8,46,37,60,45,8485,7.07,5.3,7,17,175,8310,115
"Vester",56,1853-08-07,0,9,6,15,9,24,15,8485,2.83,1.77,8,17,199,8286,175
"Vester",63,1853-08-14,0,5,3,8,4,13,7,8485,1.53,0.82,9,17,212,8273,199
"Vester",70,1853-08-21,0,3,2,3,2,6,4,8485,0.71,0.47,10,17,218,8267,212
"Vester",77,1853-08-28,0,3,2,2,1,5,3,8485,0.59,0.35,11,17,223,8262,218
"Vester",84,1853-09-04,0,2,1,2,1,4,2,8485,0.47,0.24,12,17,227,8258,223
"Vester",91,1853-09-11,0,1,0,2,1,3,1,8485,0.35,0.12,13,17,230,8255,227
"Vester",98,1853-09-18,0,0,0,0,0,0,0,8485,0,0,14,17,230,8255,230
"Vester",105,1853-09-25,0,1,1,0,0,1,1,8485,0.12,0.12,15,17,231,8254,230
"Vesterbro",0,1853-06-12,1,0,0,0,0,0,0,NA,NA,NA,0,18,0,NA,NA
"Vesterbro",7,1853-06-19,1,0,0,0,0,0,0,NA,NA,NA,1,18,0,NA,NA
"Vesterbro",14,1853-06-26,1,0,0,0,0,0,0,NA,NA,NA,2,18,0,NA,NA
"Vesterbro",21,1853-07-03,1,0,0,0,0,0,0,NA,NA,NA,3,18,0,NA,NA
"Vesterbro",28,1853-07-10,1,0,0,0,0,0,0,NA,NA,NA,4,18,0,NA,NA
"Vesterbro",35,1853-07-17,1,1,1,3,1,4,2,NA,NA,NA,5,18,4,NA,NA
"Vesterbro",42,1853-07-24,1,6,3,2,0,8,3,NA,NA,NA,6,18,12,NA,NA
"Vesterbro",49,1853-07-31,1,2,0,8,2,10,2,NA,NA,NA,7,18,22,NA,NA
"Vesterbro",56,1853-08-07,1,1,1,2,0,3,1,NA,NA,NA,8,18,25,NA,NA
"Vesterbro",63,1853-08-14,1,1,0,6,5,7,5,NA,NA,NA,9,18,32,NA,NA
"Vesterbro",70,1853-08-21,1,0,0,1,0,1,0,NA,NA,NA,10,18,33,NA,NA
"Vesterbro",77,1853-08-28,1,1,1,1,0,2,1,NA,NA,NA,11,18,35,NA,NA
"Vesterbro",84,1853-09-04,1,1,1,0,0,1,1,NA,NA,NA,12,18,36,NA,NA
"Vesterbro",91,1853-09-11,1,0,0,0,0,0,0,NA,NA,NA,13,18,36,NA,NA
"Vesterbro",98,1853-09-18,1,0,0,0,0,0,0,NA,NA,NA,14,18,36,NA,NA
"Vesterbro",105,1853-09-25,1,0,0,0,0,0,0,NA,NA,NA,15,18,36,NA,NA
