"quarter","startday.index","start.date","outside","mensick.week","mendead.week","womensick.week","womendead.week","sick.total.week","dead.total.week","est.pop.1853","normal.incidence","normal.mortality","week.id","quarterID","cum.sick","S","R"
"Christianshavn",0,1853-06-12,0,0,0,0,0,0,0,15836,0,0,0,1,407,15429,407
"Christianshavn",7,1853-06-19,0,1,1,0,0,1,1,15836,0.06,0.06,1,1,64,15772,63
"Christianshavn",14,1853-06-26,0,0,0,4,1,4,1,15836,0.25,0.06,2,1,45,15791,41
"Christianshavn",21,1853-07-03,0,4,3,9,6,13,9,15836,0.82,0.57,3,1,1176,14660,1163
"Christianshavn",28,1853-07-10,0,45,29,57,48,102,77,15836,6.44,4.86,4,1,1278,14558,1176
"Christianshavn",35,1853-07-17,0,149,108,158,119,307,227,15836,19.39,14.33,5,1,714,15122,407
"Christianshavn",42,1853-07-24,0,221,151,228,155,449,306,15836,28.35,19.32,6,1,1163,14673,714
"Christianshavn",49,1853-07-31,0,120,69,129,71,249,140,15836,15.72,8.84,7,1,405,15431,156
"Christianshavn",56,1853-08-07,0,43,15,49,20,92,35,15836,5.81,2.21,8,1,156,15680,64
"Christianshavn",63,1853-08-14,0,12,6,12,7,24,13,15836,1.52,0.82,9,1,24,15812,0
"Christianshavn",70,1853-08-21,0,9,4,8,5,17,9,15836,1.07,0.57,10,1,62,15774,45
"Christianshavn",77,1853-08-28,0,7,4,2,2,9,6,15836,0.57,0.38,11,1,34,15802,25
"Christianshavn",84,1853-09-04,0,5,3,2,1,7,4,15836,0.44,0.25,12,1,41,15795,34
"Christianshavn",91,1853-09-11,0,1,1,0,0,1,1,15836,0.06,0.06,13,1,25,15811,24
"Christianshavn",98,1853-09-18,0,2,2,0,0,2,2,15836,0.13,0.13,14,1,407,15429,405
"Christianshavn",105,1853-09-25,0,0,0,1,1,1,1,15836,0.06,0.06,15,1,63,15773,62
"Fra skibe",0,1853-06-12,0,0,0,0,0,0,0,NA,NA,NA,0,2,0,NA,NA
"Fra skibe",7,1853-06-19,0,5,5,0,0,5,5,NA,NA,NA,1,2,5,NA,NA
"Fra skibe",14,1853-06-26,0,8,4,0,0,8,4,NA,NA,NA,2,2,13,NA,NA
"Fra skibe",21,1853-07-03,0,13,8,0,0,13,8,NA,NA,NA,3,2,26,NA,NA
"Fra skibe",28,1853-07-10,0,20,13,0,0,20,13,NA,NA,NA,4,2,46,NA,NA
"Fra skibe",35,1853-07-17,0,25,15,0,0,25,15,NA,NA,NA,5,2,71,NA,NA
"Fra skibe",42,1853-07-24,0,20,10,0,0,20,10,NA,NA,NA,6,2,91,NA,NA
"Fra skibe",49,1853-07-31,0,10,3,0,0,10,3,NA,NA,NA,7,2,101,NA,NA
"Fra skibe",56,1853-08-07,0,2,1,0,0,2,1,NA,NA,NA,8,2,103,NA,NA
"Fra skibe",63,1853-08-14,0,7,5,1,1,8,6,NA,NA,NA,9,2,111,NA,NA
"Fra skibe",70,1853-08-21,0,2,2,0,0,2,2,NA,NA,NA,10,2,113,NA,NA
"Fra skibe",77,1853-08-28,0,4,1,0,0,4,1,NA,NA,NA,11,2,117,NA,NA
"Fra skibe",84,1853-09-04,0,1,0,0,0,1,0,NA,NA,NA,12,2,118,NA,NA
"Fra skibe",91,1853-09-11,0,4,1,0,0,4,1,NA,NA,NA,13,2,122,NA,NA
"Fra skibe",98,1853-09-18,0,0,0,0,0,0,0,NA,NA,NA,14,2,122,NA,NA
"Fra skibe",105,1853-09-25,0,0,0,0,0,0,0,NA,NA,NA,15,2,122,NA,NA
"Frimands",0,1853-06-12,0,0,0,0,0,0,0,4951,0,0,0,3,49,4902,49
"Frimands",7,1853-06-19,0,0,0,0,0,0,0,4951,0,0,1,3,49,4902,49
"Frimands",14,1853-06-26,0,0,0,0,0,0,0,4951,0,0,2,3,49,4902,49
"Frimands",21,1853-07-03,0,2,1,0,0,2,1,4951,0.4,0.2,3,3,49,4902,47
"Frimands",28,1853-07-10,0,1,1,1,0,2,1,4951,0.4,0.2,4,3,27,4924,25
"Frimands",35,1853-07-17,0,7,5,6,3,13,8,4951,2.63,1.62,5,3,40,4911,27
"Frimands",42,1853-07-24,0,5,4,6,5,11,9,4951,2.22,1.82,6,3,11,4940,0
"Frimands",49,1853-07-31,0,6,4,8,4,14,8,4951,2.83,1.62,7,3,25,4926,11
"Frimands",56,1853-08-07,0,3,3,2,1,5,4,4951,1.01,0.81,8,3,45,4906,40
"Frimands",63,1853-08-14,0,1,1,1,1,2,2,4951,0.4,0.4,9,3,47,4904,45
"Frimands",70,1853-08-21,0,3,2,1,0,4,2,4951,0.81,0.4,10,3,53,4898,49
"Frimands",77,1853-08-28,0,0,0,0,0,0,0,4951,0,0,11,3,53,4898,53
"Frimands",84,1853-09-04,0,0,0,0,0,0,0,4951,0,0,12,3,53,4898,53
"Frimands",91,1853-09-11,0,0,0,0,0,0,0,4951,0,0,13,3,53,4898,53
"Frimands",98,1853-09-18,0,0,0,0,0,0,0,4951,0,0,14,3,53,4898,53
"Frimands",105,1853-09-25,0,0,0,0,0,0,0,4951,0,0,15,3,49,4902,49
"Kjoebmager",0,1853-06-12,0,0,0,0,0,0,0,11544,0,0,0,4,336,11208,336
"Kjoebmager",7,1853-06-19,0,0,0,1,1,1,1,11544,0.09,0.09,1,4,70,11474,69
"Kjoebmager",14,1853-06-26,0,1,1,1,0,2,1,11544,0.17,0.09,2,4,2,11542,0
"Kjoebmager",21,1853-07-03,0,0,0,4,3,4,3,11544,0.35,0.26,3,4,44,11500,40
"Kjoebmager",28,1853-07-10,0,17,11,8,4,25,15,11544,2.17,1.3,4,4,69,11475,44
"Kjoebmager",35,1853-07-17,0,21,12,27,11,48,23,11544,4.16,1.99,5,4,149,11395,101
"Kjoebmager",42,1853-07-24,0,47,30,38,25,85,55,11544,7.36,4.76,6,4,245,11299,160
"Kjoebmager",49,1853-07-31,0,42,22,48,24,90,46,11544,7.8,3.98,7,4,335,11209,245
"Kjoebmager",56,1853-08-07,0,17,12,21,13,38,25,11544,3.29,2.17,8,4,40,11504,2
"Kjoebmager",63,1853-08-14,0,6,2,12,5,18,7,11544,1.56,0.61,9,4,88,11456,70
"Kjoebmager",70,1853-08-21,0,4,1,9,5,13,6,11544,1.13,0.52,10,4,101,11443,88
"Kjoebmager",77,1853-08-28,0,6,0,5,2,11,2,11544,0.95,0.17,11,4,160,11384,149
"Kjoebmager",84,1853-09-04,0,2,0,1,0,3,0,11544,0.26,0,12,4,339,11205,336
"Kjoebmager",91,1853-09-11,0,1,0,0,0,1,0,11544,0.09,0,13,4,336,11208,335
"Kjoebmager",98,1853-09-18,0,0,0,1,1,1,1,11544,0.09,0.09,14,4,340,11204,339
"Kjoebmager",105,1853-09-25,0,0,0,0,0,0,0,11544,0,0,15,4,336,11208,336
"Klaedebo",0,1853-06-12,0,0,0,0,0,0,0,6887,0,0,0,5,20,6867,20
"Klaedebo",7,1853-06-19,0,0,0,0,0,0,0,6887,0,0,1,5,1,6886,1
"Klaedebo",14,1853-06-26,0,0,0,0,0,0,0,6887,0,0,2,5,1,6886,1
"Klaedebo",21,1853-07-03,0,0,0,1,0,1,0,6887,0.15,0,3,5,1,6886,0
"Klaedebo",28,1853-07-10,0,5,5,2,1,7,6,6887,1.02,0.87,4,5,20,6867,13
"Klaedebo",35,1853-07-17,0,9,4,18,16,27,20,6887,3.92,2.9,5,5,51,6836,24
"Klaedebo",42,1853-07-24,0,17,8,17,12,34,20,6887,4.94,2.9,6,5,85,6802,51
"Klaedebo",49,1853-07-31,0,6,6,6,4,12,10,6887,1.74,1.45,7,5,13,6874,1
"Klaedebo",56,1853-08-07,0,2,2,4,4,6,6,6887,0.87,0.87,8,5,91,6796,85
"Klaedebo",63,1853-08-14,0,3,0,1,1,4,1,6887,0.58,0.15,9,5,95,6792,91
"Klaedebo",70,1853-08-21,0,2,0,2,1,4,1,6887,0.58,0.15,10,5,101,6786,97
"Klaedebo",77,1853-08-28,0,0,0,2,1,2,1,6887,0.29,0.15,11,5,97,6790,95
"Klaedebo",84,1853-09-04,0,1,1,1,1,2,2,6887,0.29,0.29,12,5,22,6865,20
"Klaedebo",91,1853-09-11,0,0,0,2,2,2,2,6887,0.29,0.29,13,5,24,6863,22
"Klaedebo",98,1853-09-18,0,0,0,0,0,0,0,6887,0,0,14,5,24,6863,24
"Klaedebo",105,1853-09-25,0,0,0,0,0,0,0,6887,0,0,15,5,24,6863,24
"Ladegaarden",0,1853-06-12,1,0,0,0,0,0,0,NA,NA,NA,0,6,0,NA,NA
"Ladegaarden",7,1853-06-19,1,0,0,0,0,0,0,NA,NA,NA,1,6,0,NA,NA
"Ladegaarden",14,1853-06-26,1,0,0,0,0,0,0,NA,NA,NA,2,6,0,NA,NA
"Ladegaarden",21,1853-07-03,1,3,2,12,9,15,11,NA,NA,NA,3,6,15,NA,NA
"Ladegaarden",28,1853-07-10,1,6,6,7,6,13,12,NA,NA,NA,4,6,28,NA,NA
"Ladegaarden",35,1853-07-17,1,14,11,7,4,21,15,NA,NA,NA,5,6,49,NA,NA
"Ladegaarden",42,1853-07-24,1,8,7,5,4,13,11,NA,NA,NA,6,6,62,NA,NA
"Ladegaarden",49,1853-07-31,1,5,2,2,1,7,3,NA,NA,NA,7,6,69,NA,NA
"Ladegaarden",56,1853-08-07,1,3,2,1,0,4,2,NA,NA,NA,8,6,73,NA,NA
"Ladegaarden",63,1853-08-14,1,1,0,0,0,1,0,NA,NA,NA,9,6,74,NA,NA
"Ladegaarden",70,1853-08-21,1,5,3,0,0,5,3,NA,NA,NA,10,6,79,NA,NA
"Ladegaarden",77,1853-08-28,1,1,0,0,0,1,0,NA,NA,NA,11,6,80,NA,NA
"Ladegaarden",84,1853-09-04,1,0,0,0,0,0,0,NA,NA,NA,12,6,80,NA,NA
"Ladegaarden",91,1853-09-11,1,0,0,0,0,0,0,NA,NA,NA,13,6,80,NA,NA
"Ladegaarden",98,1853-09-18,1,0,0,0,0,0,0,NA,NA,NA,14,6,80,NA,NA
"Ladegaarden",105,1853-09-25,1,0,0,0,0,0,0,NA,NA,NA,15,6,80,NA,NA
"Noerre",0,1853-06-12,0,0,0,0,0,0,0,9104,0,0,0,7,96,9008,96
"Noerre",7,1853-06-19,0,1,1,0,0,1,1,9104,0.11,0.11,1,7,32,9072,31
"Noerre",14,1853-06-26,0,0,0,0,0,0,0,9104,0,0,2,7,32,9072,32
"Noerre",21,1853-07-03,0,2,1,5,3,7,4,9104,0.77,0.44,3,7,96,9008,89
"Noerre",28,1853-07-10,0,11,9,9,6,20,15,9104,2.2,1.65,4,7,253,8851,233
"Noerre",35,1853-07-17,0,18,12,18,9,36,21,9104,3.95,2.31,5,7,186,8918,150
"Noerre",42,1853-07-24,0,19,15,28,18,47,33,9104,5.16,3.62,6,7,233,8871,186
"Noerre",49,1853-07-31,0,22,14,29,18,51,32,9104,5.6,3.51,7,7,148,8956,97
"Noerre",56,1853-08-07,0,14,6,17,11,31,17,9104,3.41,1.87,8,7,31,9073,0
"Noerre",63,1853-08-14,0,15,10,15,10,30,20,9104,3.3,2.2,9,7,64,9040,34
"Noerre",70,1853-08-21,0,12,8,8,2,20,10,9104,2.2,1.1,10,7,84,9020,64
"Noerre",77,1853-08-28,0,3,2,2,2,5,4,9104,0.55,0.44,11,7,89,9015,84
"Noerre",84,1853-09-04,0,0,0,2,2,2,2,9104,0.22,0.22,12,7,34,9070,32
"Noerre",91,1853-09-11,0,2,0,0,0,2,0,9104,0.22,0,13,7,150,8954,148
"Noerre",98,1853-09-18,0,0,0,0,0,0,0,9104,0,0,14,7,96,9008,96
"Noerre",105,1853-09-25,0,0,0,1,1,1,1,9104,0.11,0.11,15,7,97,9007,96
"Noerrebro",0,1853-06-12,1,0,0,0,0,0,0,NA,NA,NA,0,8,0,NA,NA
"Noerrebro",7,1853-06-19,1,0,0,0,0,0,0,NA,NA,NA,1,8,0,NA,NA
"Noerrebro",14,1853-06-26,1,1,1,0,0,1,1,NA,NA,NA,2,8,1,NA,NA
"Noerrebro",21,1853-07-03,1,1,1,1,0,2,1,NA,NA,NA,3,8,3,NA,NA
"Noerrebro",28,1853-07-10,1,8,7,6,4,14,11,NA,NA,NA,4,8,17,NA,NA
"Noerrebro",35,1853-07-17,1,21,15,37,24,58,39,NA,NA,NA,5,8,75,NA,NA
"Noerrebro",42,1853-07-24,1,49,34,54,34,103,68,NA,NA,NA,6,8,178,NA,NA
"Noerrebro",49,1853-07-31,1,26,21,26,17,52,38,NA,NA,NA,7,8,230,NA,NA
"Noerrebro",56,1853-08-07,1,30,19,32,20,62,39,NA,NA,NA,8,8,292,NA,NA
"Noerrebro",63,1853-08-14,1,0,15,18,9,18,24,NA,NA,NA,9,8,310,NA,NA
"Noerrebro",70,1853-08-21,1,10,6,11,8,21,14,NA,NA,NA,10,8,331,NA,NA
"Noerrebro",77,1853-08-28,1,2,1,2,1,4,2,NA,NA,NA,11,8,335,NA,NA
"Noerrebro",84,1853-09-04,1,0,0,0,0,0,0,NA,NA,NA,12,8,335,NA,NA
"Noerrebro",91,1853-09-11,1,2,2,0,0,2,2,NA,NA,NA,13,8,337,NA,NA
"Noerrebro",98,1853-09-18,1,0,0,1,1,1,1,NA,NA,NA,14,8,338,NA,NA
"Noerrebro",105,1853-09-25,1,1,0,0,0,1,0,NA,NA,NA,15,8,339,NA,NA
"Nyboder",0,1853-06-12,0,2,1,1,1,3,2,7195,0.42,0.28,0,9,579,6616,576
"Nyboder",7,1853-06-19,0,4,1,7,4,11,5,7195,1.53,0.69,1,9,368,6827,357
"Nyboder",14,1853-06-26,0,3,2,5,4,8,6,7195,1.11,0.83,2,9,315,6880,307
"Nyboder",21,1853-07-03,0,5,5,8,7,13,12,7195,1.81,1.67,3,9,188,7007,175
"Nyboder",28,1853-07-10,0,48,36,63,48,111,84,7195,15.43,11.67,4,9,299,6896,188
"Nyboder",35,1853-07-17,0,67,52,108,79,175,131,7195,24.32,18.21,5,9,175,7020,0
"Nyboder",42,1853-07-24,0,51,37,65,52,116,89,7195,16.12,12.37,6,9,484,6711,368
"Nyboder",49,1853-07-31,0,42,21,49,31,91,52,7195,12.65,7.23,7,9,575,6620,484
"Nyboder",56,1853-08-07,0,14,10,14,7,28,17,7195,3.89,2.36,8,9,343,6852,315
"Nyboder",63,1853-08-14,0,7,2,7,1,14,3,7195,1.95,0.42,9,9,357,6838,343
"Nyboder",70,1853-08-21,0,3,2,5,3,8,5,7195,1.11,0.69,10,9,307,6888,299
"Nyboder",77,1853-08-28,0,2,1,1,1,3,2,7195,0.42,0.28,11,9,582,6613,579
"Nyboder",84,1853-09-04,0,0,0,1,1,1,1,7195,0.14,0.14,12,9,583,6612,582
"Nyboder",91,1853-09-11,0,0,0,1,1,1,1,7195,0.14,0.14,13,9,576,6619,575
"Nyboder",98,1853-09-18,0,0,0,0,0,0,0,7195,0,0,14,9,357,6838,357
"Nyboder",105,1853-09-25,0,0,0,0,0,0,0,7195,0,0,15,9,0,7195,0
"Oester",0,1853-06-12,0,0,0,0,0,0,0,8553,0,0,0,10,15,8538,15
"Oester",7,1853-06-19,0,0,0,0,0,0,0,8553,0,0,1,10,15,8538,15
"Oester",14,1853-06-26,0,1,0,2,2,3,2,8553,0.35,0.23,2,10,3,8550,0
"Oester",21,1853-07-03,0,5,2,7,5,12,7,8553,1.4,0.82,3,10,15,8538,3
"Oester",28,1853-07-10,0,12,9,19,11,31,20,8553,3.62,2.34,4,10,137,8416,106
"Oester",35,1853-07-17,0,24,18,61,35,85,53,8553,9.94,6.2,5,10,222,8331,137
"Oester",42,1853-07-24,0,25,13,41,25,66,38,8553,7.72,4.44,6,10,81,8472,15
"Oester",49,1853-07-31,0,6,3,9,6,15,9,8553,1.75,1.05,7,10,96,8457,81
"Oester",56,1853-08-07,0,10,6,16,10,26,16,8553,3.04,1.87,8,10,268,8285,242
"Oester",63,1853-08-14,0,7,5,4,2,11,7,8553,1.29,0.82,9,10,233,8320,222
"Oester",70,1853-08-21,0,2,1,7,2,9,3,8553,1.05,0.35,10,10,242,8311,233
"Oester",77,1853-08-28,0,4,2,2,2,6,4,8553,0.7,0.47,11,10,102,8451,96
"Oester",84,1853-09-04,0,0,0,2,1,2,1,8553,0.23,0.12,12,10,104,8449,102
"Oester",91,1853-09-11,0,0,0,1,0,1,0,8553,0.12,0,13,10,105,8448,104
"Oester",98,1853-09-18,0,0,0,0,0,0,0,8553,0,0,14,10,105,8448,105
"Oester",105,1853-09-25,0,0,0,1,0,1,0,8553,0.12,0,15,10,106,8447,105
"Oesterbro",0,1853-06-12,1,0,0,0,0,0,0,NA,NA,NA,0,11,3,NA,NA
"Oesterbro",7,1853-06-19,1,0,0,0,0,0,0,NA,NA,NA,1,11,3,NA,NA
"Oesterbro",14,1853-06-26,1,0,0,0,0,0,0,NA,NA,NA,2,11,2,NA,NA
"Oesterbro",21,1853-07-03,1,1,0,0,0,1,0,NA,NA,NA,3,11,3,NA,NA
"Oesterbro",28,1853-07-10,1,0,0,0,0,0,0,NA,NA,NA,4,11,3,NA,NA
"Oesterbro",35,1853-07-17,1,8,5,7,6,15,11,NA,NA,NA,5,11,18,NA,NA
"Oesterbro",42,1853-07-24,1,7,4,15,10,22,14,NA,NA,NA,6,11,40,NA,NA
"Oesterbro",49,1853-07-31,1,3,2,1,1,4,3,NA,NA,NA,7,11,44,NA,NA
"Oesterbro",56,1853-08-07,1,0,0,0,0,0,0,NA,NA,NA,8,11,0,NA,NA
"Oesterbro",63,1853-08-14,1,1,0,0,0,1,0,NA,NA,NA,9,11,1,NA,NA
"Oesterbro",70,1853-08-21,1,0,0,0,0,0,0,NA,NA,NA,10,11,1,NA,NA
"Oesterbro",77,1853-08-28,1,0,0,0,0,0,0,NA,NA,NA,11,11,1,NA,NA
"Oesterbro",84,1853-09-04,1,0,0,1,0,1,0,NA,NA,NA,12,11,2,NA,NA
"Oesterbro",91,1853-09-11,1,0,0,0,0,0,0,NA,NA,NA,13,11,2,NA,NA
"Oesterbro",98,1853-09-18,1,0,0,0,0,0,0,NA,NA,NA,14,11,2,NA,NA
"Oesterbro",105,1853-09-25,1,0,0,0,0,0,0,NA,NA,NA,15,11,2,NA,NA
"Rosenborg",0,1853-06-12,0,0,0,0,0,0,0,10214,0,0,0,12,18,10196,18
"Rosenborg",7,1853-06-19,0,0,0,3,1,3,1,10214,0.29,0.1,1,12,21,10193,18
"Rosenborg",14,1853-06-26,0,6,3,12,5,18,8,10214,1.76,0.78,2,12,18,10196,0
"Rosenborg",21,1853-07-03,0,4,3,7,3,11,6,10214,1.08,0.59,3,12,298,9916,287
"Rosenborg",28,1853-07-10,0,25,16,7,5,32,21,10214,3.13,2.06,4,12,330,9884,298
"Rosenborg",35,1853-07-17,0,23,14,30,19,53,33,10214,5.19,3.23,5,12,383,9831,330
"Rosenborg",42,1853-07-24,0,42,23,47,28,89,51,10214,8.71,4.99,6,12,110,10104,21
"Rosenborg",49,1853-07-31,0,31,21,43,29,74,50,10214,7.24,4.9,7,12,184,10030,110
"Rosenborg",56,1853-08-07,0,20,10,20,9,40,19,10214,3.92,1.86,8,12,224,9990,184
"Rosenborg",63,1853-08-14,0,11,2,20,12,31,14,10214,3.04,1.37,9,12,255,9959,224
"Rosenborg",70,1853-08-21,0,11,8,10,10,21,18,10214,2.06,1.76,10,12,276,9938,255
"Rosenborg",77,1853-08-28,0,3,3,2,1,5,4,10214,0.49,0.39,11,12,281,9933,276
"Rosenborg",84,1853-09-04,0,1,1,1,1,2,2,10214,0.2,0.2,12,12,283,9931,281
"Rosenborg",91,1853-09-11,0,2,1,2,1,4,2,10214,0.39,0.2,13,12,287,9927,283
"Rosenborg",98,1853-09-18,0,0,0,0,0,0,0,10214,0,0,14,12,287,9927,287
"Rosenborg",105,1853-09-25,0,0,0,0,0,0,0,10214,0,0,15,12,287,9927,287
"Snarens",0,1853-06-12,0,0,0,0,0,0,0,4674,0,0,0,13,116,4558,116
"Snarens",7,1853-06-19,0,0,0,0,0,0,0,4674,0,0,1,13,116,4558,116
"Snarens",14,1853-06-26,0,3,2,0,0,3,2,4674,0.64,0.43,2,13,3,4671,0
"Snarens",21,1853-07-03,0,0,0,0,0,0,0,4674,0,0,3,13,3,4671,3
"Snarens",28,1853-07-10,0,0,0,1,1,1,1,4674,0.21,0.21,4,13,4,4670,3
"Snarens",35,1853-07-17,0,5,1,10,4,15,5,4674,3.21,1.07,5,13,19,4655,4
"Snarens",42,1853-07-24,0,35,28,25,18,60,46,4674,12.84,9.84,6,13,79,4595,19
"Snarens",49,1853-07-31,0,6,4,9,4,15,8,4674,3.21,1.71,7,13,94,4580,79
"Snarens",56,1853-08-07,0,3,3,7,3,10,6,4674,2.14,1.28,8,13,104,4570,94
"Snarens",63,1853-08-14,0,2,1,3,2,5,3,4674,1.07,0.64,9,13,109,4565,104
"Snarens",70,1853-08-21,0,1,0,2,0,3,0,4674,0.64,0,10,13,112,4562,109
"Snarens",77,1853-08-28,0,3,1,1,0,4,1,4674,0.86,0.21,11,13,116,4558,112
"Snarens",84,1853-09-04,0,0,0,0,0,0,0,4674,0,0,12,13,116,4558,116
"Snarens",91,1853-09-11,0,6,2,3,0,9,2,4674,1.93,0.43,13,13,125,4549,116
"Snarens",98,1853-09-18,0,1,1,1,1,2,2,4674,0.43,0.43,14,13,127,4547,125
"Snarens",105,1853-09-25,0,0,0,0,0,0,0,4674,0,0,15,13,116,4558,116
"St. Annae Oester",0,1853-06-12,0,1,0,0,0,1,0,11917,0.08,0,0,14,1148,10769,1147
"St. Annae Oester",7,1853-06-19,0,1,1,1,0,2,1,11917,0.17,0.08,1,14,2,11915,0
"St. Annae Oester",14,1853-06-26,0,4,4,2,2,6,6,11917,0.5,0.5,2,14,8,11909,2
"St. Annae Oester",21,1853-07-03,0,35,28,30,26,65,54,11917,5.45,4.53,3,14,769,11148,704
"St. Annae Oester",28,1853-07-10,0,133,102,173,142,306,244,11917,25.68,20.47,4,14,1075,10842,769
"St. Annae Oester",35,1853-07-17,0,188,138,316,239,504,377,11917,42.29,31.64,5,14,512,11405,8
"St. Annae Oester",42,1853-07-24,0,59,50,133,101,192,151,11917,16.11,12.67,6,14,704,11213,512
"St. Annae Oester",49,1853-07-31,0,15,11,22,15,37,26,11917,3.1,2.18,7,14,1130,10787,1093
"St. Annae Oester",56,1853-08-07,0,7,5,10,6,17,11,11917,1.43,0.92,8,14,1147,10770,1130
"St. Annae Oester",63,1853-08-14,0,7,5,9,4,16,9,11917,1.34,0.76,9,14,1091,10826,1075
"St. Annae Oester",70,1853-08-21,0,1,1,1,0,2,1,11917,0.17,0.08,10,14,1093,10824,1091
"St. Annae Oester",77,1853-08-28,0,3,1,0,0,3,1,11917,0.25,0.08,11,14,1152,10765,1149
"St. Annae Oester",84,1853-09-04,0,1,0,0,0,1,0,11917,0.08,0,12,14,1153,10764,1152
"St. Annae Oester",91,1853-09-11,0,0,0,1,0,1,0,11917,0.08,0,13,14,1154,10763,1153
"St. Annae Oester",98,1853-09-18,0,0,0,0,0,0,0,11917,0,0,14,14,1148,10769,1148
"St. Annae Oester",105,1853-09-25,0,1,1,0,0,1,1,11917,0.08,0.08,15,14,1149,10768,1148
"St. Annae Vester",0,1853-06-12,0,0,0,1,1,1,1,24655,0.04,0.04,0,15,142,24513,141
"St. Annae Vester",7,1853-06-19,0,5,5,2,1,7,6,24655,0.28,0.24,1,15,149,24506,142
"St. Annae Vester",14,1853-06-26,0,20,17,20,1,40,18,24655,1.62,0.73,2,15,189,24466,149
"St. Annae Vester",21,1853-07-03,0,76,59,65,47,141,106,24655,5.72,4.3,3,15,141,24514,0
"St. Annae Vester",28,1853-07-10,0,214,151,169,115,383,266,24655,15.53,10.79,4,15,739,23916,356
"St. Annae Vester",35,1853-07-17,0,235,148,257,153,492,301,24655,19.96,12.21,5,15,1231,23424,739
"St. Annae Vester",42,1853-07-24,0,168,96,206,131,374,227,24655,15.17,9.21,6,15,1605,23050,1231
"St. Annae Vester",49,1853-07-31,0,81,45,86,46,167,91,24655,6.77,3.69,7,15,356,24299,189
"St. Annae Vester",56,1853-08-07,0,34,21,42,21,76,42,24655,3.08,1.7,8,15,1721,22934,1645
"St. Annae Vester",63,1853-08-14,0,14,8,26,8,40,16,24655,1.62,0.65,9,15,1761,22894,1721
"St. Annae Vester",70,1853-08-21,0,14,7,5,0,19,7,24655,0.77,0.28,10,15,1624,23031,1605
"St. Annae Vester",77,1853-08-28,0,8,5,4,0,12,5,24655,0.49,0.2,11,15,1636,23019,1624
"St. Annae Vester",84,1853-09-04,0,2,0,1,0,3,0,24655,0.12,0,12,15,1639,23016,1636
"St. Annae Vester",91,1853-09-11,0,0,0,2,1,2,1,24655,0.08,0.04,13,15,1641,23014,1639
"St. Annae Vester",98,1853-09-18,0,2,2,2,1,4,3,24655,0.16,0.12,14,15,1645,23010,1641
"St. Annae Vester",105,1853-09-25,0,0,1,0,0,0,1,24655,0,0.04,15,15,1645,23010,1645
"Strand",0,1853-06-12,0,0,0,0,0,0,0,2553,0,0,0,16,7,2546,7
"Strand",7,1853-06-19,0,0,0,0,0,0,0,2553,0,0,1,16,7,2546,7
"Strand",14,1853-06-26,0,0,0,0,0,0,0,2553,0,0,2,16,3,2550,3
"Strand",21,1853-07-03,0,0,0,0,0,0,0,2553,0,0,3,16,0,2553,0
"Strand",28,1853-07-10,0,2,1,1,0,3,1,2553,1.18,0.39,4,16,3,2550,0
"Strand",35,1853-07-17,0,1,0,2,1,3,1,2553,1.18,0.39,5,16,20,2533,17
"Strand",42,1853-07-24,0,4,4,4,1,8,5,2553,3.13,1.96,6,16,15,2538,7
"Strand",49,1853-07-31,0,0,0,2,1,2,1,2553,0.78,0.39,7,16,17,2536,15
"Strand",56,1853-08-07,0,1,0,1,0,2,0,2553,0.78,0,8,16,5,2548,3
"Strand",63,1853-08-14,0,0,0,0,0,0,0,2553,0,0,9,16,5,2548,5
"Strand",70,1853-08-21,0,1,0,1,1,2,1,2553,0.78,0.39,10,16,7,2546,5
"Strand",77,1853-08-28,0,0,0,0,0,0,0,2553,0,0,11,16,7,2546,7
"Strand",84,1853-09-04,0,0,0,0,0,0,0,2553,0,0,12,16,7,2546,7
"Strand",91,1853-09-11,0,0,0,0,0,0,0,2553,0,0,13,16,7,2546,7
"Strand",98,1853-09-18,0,0,0,0,0,0,0,2553,0,0,14,16,0,2553,0
"Strand",105,1853-09-25,0,0,0,0,0,0,0,2553,0,0,15,16,3,2550,3
"Vester",0,1853-06-12,0,0,0,0,0,0,0,8485,0,0,0,17,0,8485,0
"Vester",7,1853-06-19,0,1,1,0,0,1,1,8485,0.12,0.12,1,17,1,8484,0
"Vester",14,1853-06-26,0,0,0,0,0,0,0,8485,0,0,2,17,0,8485,0
"Vester",21,1853-07-03,0,1,1,3,3,4,4,8485,0.47,0.47,3,17,220,8265,216
"Vester",28,1853-07-10,0,3,2,1,0,4,2,8485,0.47,0.24,4,17,224,8261,220
"Vester",35,1853-07-17,0,1,1,6,6,7,7,8485,0.82,0.82,5,17,231,8254,224
"Vester",42,1853-07-24,0,30,19,69,59,99,78,8485,11.67,9.19,6,17,100,8385,1
"Vester",49,1853-07-31,0,14,8,46,37,60,45,8485,7.07,5.3,7,17,160,8325,100
"Vester",56,1853-08-07,0,9,6,15,9,24,15,8485,2.83,1.77,8,17,184,8301,160
"Vester",63,1853-08-14,0,5,3,8,4,13,7,8485,1.53,0.82,9,17,197,8288,184
"Vester",70,1853-08-21,0,3,2,3,2,6,4,8485,0.71,0.47,10,17,203,8282,197
"Vester",77,1853-08-28,0,3,2,2,1,5,3,8485,0.59,0.35,11,17,208,8277,203
"Vester",84,1853-09-04,0,2,1,2,1,4,2,8485,0.47,0.24,12,17,212,8273,208
"Vester",91,1853-09-11,0,1,0,2,1,3,1,8485,0.35,0.12,13,17,215,8270,212
"Vester",98,1853-09-18,0,0,0,0,0,0,0,8485,0,0,14,17,215,8270,215
"Vester",105,1853-09-25,0,1,1,0,0,1,1,8485,0.12,0.12,15,17,216,8269,215
"Vesterbro",0,1853-06-12,1,0,0,0,0,0,0,NA,NA,NA,0,18,0,NA,NA
"Vesterbro",7,1853-06-19,1,0,0,0,0,0,0,NA,NA,NA,1,18,0,NA,NA
"Vesterbro",14,1853-06-26,1,0,0,0,0,0,0,NA,NA,NA,2,18,0,NA,NA
"Vesterbro",21,1853-07-03,1,0,0,0,0,0,0,NA,NA,NA,3,18,0,NA,NA
"Vesterbro",28,1853-07-10,1,0,0,0,0,0,0,NA,NA,NA,4,18,0,NA,NA
"Vesterbro",35,1853-07-17,1,1,1,3,1,4,2,NA,NA,NA,5,18,4,NA,NA
"Vesterbro",42,1853-07-24,1,6,3,2,0,8,3,NA,NA,NA,6,18,12,NA,NA
"Vesterbro",49,1853-07-31,1,2,0,8,2,10,2,NA,NA,NA,7,18,22,NA,NA
"Vesterbro",56,1853-08-07,1,1,1,2,0,3,1,NA,NA,NA,8,18,35,NA,NA
"Vesterbro",63,1853-08-14,1,1,0,6,5,7,5,NA,NA,NA,9,18,29,NA,NA
"Vesterbro",70,1853-08-21,1,0,0,1,0,1,0,NA,NA,NA,10,18,30,NA,NA
"Vesterbro",77,1853-08-28,1,1,1,1,0,2,1,NA,NA,NA,11,18,32,NA,NA
"Vesterbro",84,1853-09-04,1,1,1,0,0,1,1,NA,NA,NA,12,18,36,NA,NA
"Vesterbro",91,1853-09-11,1,0,0,0,0,0,0,NA,NA,NA,13,18,35,NA,NA
"Vesterbro",98,1853-09-18,1,0,0,0,0,0,0,NA,NA,NA,14,18,35,NA,NA
"Vesterbro",105,1853-09-25,1,0,0,0,0,0,0,NA,NA,NA,15,18,32,NA,NA
